11111111111111111
1000C00100000P001
10000001010000001
10010001010C00E01
10010000010000001
10000000000000001
11111111111111111