11111111111111111
1000C00100000P001
10000M01010111001
10010001010C01E01
10010000010001001
11111111111111111